----------------------------
----------------------------
----------------------------
****************************
*------------**------------*	
*-****-*****-**-*****-****-*
*-****-*****-**-*****-****-*
*-****-*****-**-*****-****-*
*--------------------------*
*-****-**-********-**-****-*
*-****-**-********-**-****-*
*------**----**----**------*
******-*****-**-*****-******
******-*****-**-*****-******
******-**----------**-******
******-**-********-**-******
******-**-********-**-******
----------********----------
******-**-********-**-******
******-**-********-**-******
******-**----------**-******
******-**-********-**-******
******-**-********-**-******
*------------**------------*
*-****-*****-**-*****-****-*
*-****-*****-**-*****-****-*
*---**----------------**---*
***-**-**-********-**-**-***
***-**-**-********-**-**-***
*------**----**----**------*
*-**********-**-**********-*
*-**********-**-**********-*
*--------------------------*
****************************
----------------------------
----------------------------
